
-1 -1 -1 -1 -1 -1 -1 -1 -1 -1 -1 -1  -1 -1 -1 -1 -1 -1 -1 -1 -1 -1 -1 -1   -1 -1 -1 -1 -1 -1 -1 -1 -1 -1 -1 -1   -1 -1 -1 -1 -1 -1 -1 -1 -1 -1 -1 -1   -1 -1 -1 -1 -1 -1 -1 -1 -1 -1 -1 -1   -1 -1 -1 -1 -1 -1 -1 -1 -1 -1 -1 -1   -1 -1 -1 -1 -1 -1 -1 -1 -1 -1 -1 -1   -1 -1 -1 -1 -1 -1 -1 -1 -1 -1 -1 -1   -1 -1 -1 -1 -1 -1 -1 -1 -1 -1 -1 -1   -1 -1 -1 -1 -1 -1 -1 -1 -1 -1 -1 -1   -1 -1 -1 -1 -1 -1 -1 -1 -1 -1 -1 -1   -1 -1 -1 -1 -1 -1 -1 -1 -1 -1 -1 -1   -1 -1 -1 -1 -1 -1 -1 -1 -1 -1 -1 -1   -1 -1 -1 -1 -1 -1 -1 -1 -1 -1 -1 -1
-1 -1 -1 -1 -1 -1 -1 -1 -1 -1 -1 -1  -1 -1 -1 -1 -1 -1 -1 -1 -1 -1 -1 -1   -1 -1 -1 -1 -1 -1 -1 -1 -1 -1 -1 -1   -1 -1 -1 -1 -1 -1 -1 -1 -1 -1 -1 -1   -1 -1 -1 -1 -1 -1 -1 -1 -1 -1 -1 -1   -1 -1 -1 -1 -1 -1 -1 -1 -1 -1 -1 -1   -1 -1 -1 -1 -1 -1 -1 -1 -1 -1 -1 -1   -1 -1 -1 -1 -1 -1 -1 -1 -1 -1 -1 -1   -1 -1 -1 -1 -1 -1 -1 -1 -1 -1 -1 -1   -1 -1 -1 -1 -1 -1 -1 -1 -1 -1 -1 -1   -1 -1 -1 -1 -1 -1 -1 -1 -1 -1 -1 -1   -1 -1 -1 -1 -1 -1 -1 -1 -1 -1 -1 -1   -1 -1 -1 -1 -1 -1 -1 -1 -1 -1 -1 -1   -1 -1 -1 -1 -1 -1 -1 -1 -1 -1 -1 -1
-1 -1 -1 -1 -1 -1 -1 -1 -1 -1 -1 -1  -1 -1 -1 -1 -1 -1 -1 -1 -1 -1 -1 -1   -1 -1 -1 -1 -1 -1 -1 -1 -1 -1 -1 -1   -1 -1 -1 -1 -1 -1 -1 -1 -1 -1 -1 -1   -1 -1 -1 -1 -1 -1 -1 -1 -1 -1 -1 -1   -1 -1 -1 -1 -1 -1 -1 -1 -1 -1 -1 -1   -1 -1 -1 -1 -1 -1 -1 -1 -1 -1 -1 -1   -1 -1 -1 -1 -1 -1 -1 -1 -1 -1 -1 -1   -1 -1 -1 -1 -1 -1 -1 -1 -1 -1 -1 -1   -1 -1 -1 -1 -1 -1 -1 -1 -1 -1 -1 -1   -1 -1 -1 -1 -1 -1 -1 -1 -1 -1 -1 -1   -1 -1 -1 -1 -1 -1 -1 -1 -1 -1 -1 -1   -1 -1 -1 -1 -1 -1 -1 -1 -1 -1 -1 -1   -1 -1 -1 -1 -1 -1 -1 -1 -1 -1 -1 -1
-1 -1 -1 -1 -1 -1 -1 -1 -1 -1 -1 -1  -1 -1 -1 -1 -1 -1 -1 -1 -1 -1 -1 -1   -1 -1 -1 -1 -1 -1 -1 -1 -1 -1 -1 -1   -1 -1 -1 -1 -1 -1 -1 -1 -1 -1 -1 -1   -1 -1 -1 -1 -1 -1 -1 -1 -1 -1 -1 -1   -1 -1 -1 -1 -1 -1 -1 -1 -1 -1 -1 -1   -1 -1 -1 -1 -1 -1 -1 -1 -1 -1 -1 -1   -1 -1 -1 -1 -1 -1 -1 -1 -1 -1 -1 -1   -1 -1 -1 -1 -1 -1 -1 -1 -1 -1 -1 -1   -1 -1 -1 -1 -1 -1 -1 -1 -1 -1 -1 -1   -1 -1 -1 -1 -1 -1 -1 -1 -1 -1 -1 -1   -1 -1 -1 -1 -1 -1 -1 -1 -1 -1 -1 -1   -1 -1 -1 -1 -1 -1 -1 -1 -1 -1 -1 -1   -1 -1 -1 -1 -1 -1 -1 -1 -1 -1 -1 -1
-1 -1 -1 -1 -1 -1 -1 -1 -1 -1 -1 -1  -1 -1 -1 -1 -1 -1 -1 -1 -1 -1 -1 -1   -1 -1 -1 -1 -1 -1 -1 -1 -1 -1 -1 -1   -1 -1 -1 -1 -1 -1 -1 -1 -1 -1 -1 -1   -1 -1 -1 -1 -1 -1 -1 -1 -1 -1 -1 -1   -1 -1 -1 -1 -1 -1 -1 -1 -1 -1 -1 -1   -1 -1 -1 -1 -1 -1 -1 -1 -1 -1 -1 -1   -1 -1 -1 -1 -1 -1 -1 -1 -1 -1 -1 -1   -1 -1 -1 -1 -1 -1 -1 -1 -1 -1 -1 -1   -1 -1 -1 -1 -1 -1 -1 -1 -1 -1 -1 -1   -1 -1 -1 -1 -1 -1 -1 -1 -1 -1 -1 -1   -1 -1 -1 -1 -1 -1 -1 -1 -1 -1 -1 -1   -1 -1 -1 -1 -1 -1 -1 -1 -1 -1 -1 -1   -1 -1 -1 -1 -1 -1 -1 -1 -1 -1 -1 -1
-1 -1 -1 -1 -1 -1 -1 -1 -1 -1 -1 -1  -1 -1 -1 -1 -1 -1 -1 -1 -1 -1 -1 -1   -1 -1 -1 -1 -1 -1 -1 -1 -1 -1 -1 -1   -1 -1 -1 -1 -1 -1 -1 -1 -1 -1 -1 -1   -1 -1 -1 -1 -1 -1 -1 -1 -1 -1 -1 -1   -1 -1 -1 -1 -1 -1 -1 -1 -1 -1 -1 -1   -1 -1 -1 -1 -1 -1 -1 -1 -1 -1 -1 -1   -1 -1 -1 -1 -1 -1 -1 -1 -1 -1 -1 -1   -1 -1 -1 -1 -1 -1 -1 -1 -1 -1 -1 -1   -1 -1 -1 -1 -1 -1 -1 -1 -1 -1 -1 -1   -1 -1 -1 -1 -1 -1 -1 -1 -1 -1 -1 -1   -1 -1 -1 -1 -1 -1 -1 -1 -1 -1 -1 -1   -1 -1 -1 -1 -1 -1 -1 -1 -1 -1 -1 -1   -1 -1 -1 -1 -1 -1 -1 -1 -1 -1 -1 -1
-1 -1 -1 -1 -1 -1 -1 -1 -1 -1 -1 -1  -1 -1 -1 -1 -1 -1 -1 -1 -1 -1 -1 -1   -1 -1 -1 -1 -1 -1 -1 -1 -1 -1 -1 -1   -1 -1 -1 -1 -1 -1 -1 -1 -1 -1 -1 -1   -1 -1 -1 -1 -1 -1 -1 -1 -1 -1 -1 -1   -1 -1 -1 -1 -1 -1 -1 -1 -1 -1 -1 -1   -1 -1 -1 -1 -1 -1 -1 -1 -1 -1 -1 -1   -1 -1 -1 -1 -1 -1 -1 -1 -1 -1 -1 -1   -1 -1 -1 -1 -1 -1 -1 -1 -1 -1 -1 -1   -1 -1 -1 -1 -1 -1 -1 -1 -1 -1 -1 -1   -1 -1 -1 -1 -1 -1 -1 -1 -1 -1 -1 -1   -1 -1 -1 -1 -1 -1 -1 -1 -1 -1 -1 -1   -1 -1 -1 -1 -1 -1 -1 -1 -1 -1 -1 -1   -1 -1 -1 -1 -1 -1 -1 -1 -1 -1 -1 -1
                                                                                                                                                                                                                                                                                                                                                                                                                                                                                                                                                
-1 -1 -1 -1 -1 -1 -1 -1 -1 -1 -1 -1  -1 -1 -1 -1 -1 -1 -1 -1 -1 -1 -1 -1   -1 -1 -1 -1 -1 -1 -1 -1 -1 -1 -1 -1   -1 -1 -1 -1 -1 -1 -1 -1 -1 -1 -1 -1   -1 -1 29 29 29 29 29 29 29 29 29 29   29 29 29 29 29 29 29 29 29 29 29 29   29 29 29 29 29 29 29 29 29 29 29 29   29 29 29 29 29 29 29 29 29 29 -1 -1   -1 -1 -1 -1 -1 -1 -1 -1 -1 -1 -1 -1   -1 -1 -1 -1 -1 -1 -1 -1 -1 -1 -1 -1   -1 -1 -1 -1 -1 -1 -1 -1 -1 -1 -1 -1   -1 -1 -1 -1 -1 -1 -1 -1 -1 -1 -1 -1   -1 -1 -1 -1 -1 -1 -1 -1 -1 -1 -1 -1   -1 -1 -1 -1 -1 -1 -1 -1 -1 -1 -1 -1
-1 -1 -1 -1 -1 -1 -1 -1 -1 -1 -1 -1  -1 -1 -1 -1 -1 -1 -1 -1 -1 -1 -1 -1   -1 -1 -1 -1 -1 -1 -1 -1 -1 -1 -1 -1   -1 -1 -1 -1 -1 -1 -1 -1 -1 -1 -1 -1   -1 -1 -1 -1 -1 -1 -1 -1 -1 -1 -1 -1   -1 -1 -1 -1 -1 -1 -1 -1 -1 -1 -1 -1   -1 -1 -1 -1 -1 -1 -1 -1 -1 -1 -1 -1   -1 -1 -1 -1 -1 -1 -1 -1 -1 -1 -1 -1   -1 -1 -1 -1 -1 -1 -1 -1 -1 -1 -1 -1   -1 -1 -1 -1 -1 -1 -1 -1 -1 -1 -1 -1   -1 -1 -1 -1 -1 -1 -1 -1 -1 -1 -1 -1   -1 -1 -1 -1 -1 -1 -1 -1 -1 -1 -1 -1   -1 -1 -1 -1 -1 -1 -1 -1 -1 -1 -1 -1   -1 -1 -1 -1 -1 -1 -1 -1 -1 -1 -1 -1
-1 -1 -1 -1 -1 -1 -1 -1 -1 -1 -1 -1  -1 -1 -1 -1 -1 -1 -1 -1 -1 -1 -1 -1   -1 -1 -1 -1 -1 -1 -1 -1 -1 -1 -1 -1   -1 -1 -1 -1 -1 -1 -1 -1 -1 -1 -1 -1   -1 -1 -1 -1 -1 -1 -1 -1 -1 -1 -1 -1   -1 -1 -1 -1 -1 -1 -1 -1 -1 -1 -1 -1   -1 -1 -1 -1 -1 -1 -1 -1 -1 -1 -1 -1   -1 -1 -1 -1 -1 -1 -1 -1 -1 -1 -1 -1   -1 -1 -1 -1 -1 -1 -1 -1 -1 -1 -1 -1   -1 -1 -1 -1 -1 -1 -1 -1 -1 -1 -1 -1   -1 -1 -1 -1 -1 -1 -1 -1 -1 -1 -1 -1   -1 -1 -1 -1 -1 -1 -1 -1 -1 -1 -1 -1   -1 -1 -1 -1 -1 -1 -1 -1 -1 -1 -1 -1   -1 -1 -1 -1 -1 -1 -1 -1 -1 -1 -1 -1
-1 -1 -1 -1 -1 -1 -1 -1 -1 -1 -1 -1  -1 -1 -1 -1 -1 -1 -1 -1 -1 -1 -1 -1   -1 -1 -1 -1 -1 -1 -1 -1 -1 -1 -1 -1   -1 -1 -1 -1 -1 -1 -1 -1 -1 -1 -1 -1   -1 -1 -1 -1 -1 -1 -1 -1 -1 -1 -1 -1   -1 -1 -1 -1 -1 -1 -1 -1 -1 -1 -1 -1   -1 -1 -1 -1 -1 -1 -1 -1 -1 -1 -1 -1   -1 -1 -1 -1 -1 -1 -1 -1 -1 -1 -1 -1   -1 -1 -1 -1 -1 -1 -1 -1 -1 -1 -1 -1   -1 -1 -1 -1 -1 -1 -1 -1 -1 -1 -1 -1   -1 -1 -1 -1 -1 -1 -1 -1 -1 -1 64 65   66 67 73 -1 -1 -1 -1 -1 -1 -1 -1 -1   -1 -1 -1 -1 -1 -1 -1 -1 -1 -1 -1 -1   -1 -1 -1 -1 -1 -1 -1 -1 -1 -1 -1 -1
-1 -1 -1 -1 -1 -1 -1 -1 -1 -1 -1 -1  -1 -1 -1 -1 -1 -1 -1 -1 -1 -1 -1 -1   -1 -1 -1 -1 -1 -1 -1 -1 -1 -1 -1 -1   -1 -1 -1 -1 -1 -1 -1 -1 -1 -1 -1 -1   -1 -1 30 30 30 30 30 30 30 30 30 30   30 30 30 30 30 30 30 30 30 30 30 30   30 30 30 30 30 30 30 30 30 30 30 30   30 30 30 30 -1 -1 -1 -1 -1 -1 -1 -1   -1 -1 -1 -1 -1 -1 -1 -1 -1 -1 -1 -1   -1 -1 -1 -1 -1 -1 -1 -1 -1 -1 -1 -1   -1 -1 75 57 58 59 60 61 62 63 -1 -1   -1 -1 -1 -1 76 10 10 10 10 10 10 10   10 10 10 10 10 77 -1 -1 -1 -1 -1 -1   -1 -1 -1 -1 -1 -1 -1 -1 -1 -1 -1 -1
-1 -1 -1 -1 -1 -1 -1 -1 -1 -1 -1 -1  -1 -1 -1 -1 -1 -1 -1 -1 -1 -1 -1 -1   -1 -1 -1 -1 -1 -1 -1 -1 -1 -1 -1 -1   -1 -1 -1 -1 -1 -1 -1 -1 -1 -1 -1 -1   -1 -1 -1 -1 -1 -1 -1 -1 -1 -1 -1 -1   -1 -1 -1 -1 -1 -1 -1 -1 -1 -1 -1 -1   -1 -1 -1 -1 -1 -1 -1 -1 -1 -1 -1 -1   -1 -1 -1 -1 -1 -1 -1 -1 -1 -1 -1 -1   -1 -1 -1 -1 -1 -1 -1 -1 -1 -1 -1 -1   -1 -1 -1 -1 -1 -1 -1 -1 -1 -1 -1 -1   -1 -1 -1 -1 -1 -1 -1 -1 -1 -1 -1 -1   -1 -1 -1 -1 -1 -1 -1 -1 -1 -1 -1 -1   -1 -1 -1 -1 -1 -1 -1 -1 -1 -1 -1 -1   -1 -1 -1 -1 -1 -1 -1 -1 -1 -1 -1 -1
-1 -1 -1 -1 -1 -1 -1 -1 -1 -1 -1 -1  -1 -1 -1 -1 -1 -1 -1 -1 -1 -1 -1 -1   -1 -1 -1 -1 -1 -1 -1 -1 -1 -1 -1 -1   -1 -1 -1 -1 -1 -1 -1 -1 -1 -1 -1 -1   -1 -1 -1 -1 -1 -1 -1 -1 -1 -1 -1 -1   -1 -1 -1 -1 -1 -1 -1 -1 -1 -1 -1 -1   -1 -1 -1 -1 -1 -1 -1 -1 -1 -1 -1 -1   -1 -1 -1 -1 -1 -1 -1 -1 -1 -1 -1 -1   -1 -1 -1 -1 -1 -1 -1 -1 -1 -1 -1 -1   -1 -1 -1 -1 -1 -1 -1 -1 -1 -1 -1 -1   -1 -1 -1 -1 -1 -1 -1 -1 -1 -1 -1 -1   -1 -1 -1 -1 -1 -1 -1 -1 -1 -1 -1 -1   -1 -1 -1 -1 -1 -1 -1 -1 -1 -1 -1 -1   -1 -1 -1 -1 -1 -1 -1 -1 -1 -1 -1 -1
                                                                                                                                                                                                                                                                                                                                                                                                                                                                                                                                                
-1 -1 -1 -1 -1 -1 -1 -1 -1 -1 -1 -1  -1 -1 -1 -1 -1 -1 -1 -1 -1 -1 -1 -1   -1 -1 -1 -1 -1 -1 -1 -1 -1 -1 -1 -1   -1 -1 -1 -1 -1 -1 -1 -1 -1 -1 -1 -1   -1 -1 -1 -1 -1 -1 -1 -1 -1 -1 -1 -1   -1 -1 -1 -1 -1 -1 -1 -1 -1 -1 -1 -1   -1 -1 -1 -1 -1 -1 -1 -1 -1 -1 -1 -1   -1 -1 -1 -1 -1 -1 -1 -1 -1 -1 -1 -1   -1 -1 -1 -1 -1 -1 -1 -1 -1 -1 -1 -1   -1 -1 -1 -1 -1 -1 -1 -1 -1 -1 -1 -1   -1 -1 -2 -2 74 00 00 00 00 00 00 00   00 00 00 -1 -1 -1 -1 -1 -1 -1 -1 -1   -1 -1 -1 -1 -1 -1 -1 -1 -1 -1 -1 -1   -1 -1 -1 -1 -1 -1 -1 -1 -1 -1 -1 -1
-1 -1 -1 -1 -1 -1 -1 -1 -1 -1 -1 -1  -1 -1 -1 -1 -1 -1 -1 -1 -1 -1 -1 -1   -1 -1 -1 -1 -1 -1 -1 -1 -1 -1 -1 -1   -1 -1 -1 -1 -1 -1 -1 -1 -1 -1 -1 -1   -1 -1 31 31 31 31 31 31 31 31 31 31   31 31 31 31 31 31 31 31 31 31 31 31   31 31 31 31 31 31 31 31 31 31 31 31   31 31 31 31 31 31 31 31 31 31 -1 -1   -1 -1 -1 -1 -1 -1 -1 -1 -1 -1 -1 -1   -1 -1 -1 -1 -1 -1 -1 -1 -1 -1 -1 -1   -1 -1 -2 -2 -2 -2 -2 -2 -2 -2 -2 -2   -2 -2 -2 -1 -1 -1 -1 -1 -1 -1 -1 -1   -1 -1 -1 -1 -1 -1 -1 -1 -1 -1 -1 -1   -1 -1 -1 -1 -1 -1 -1 -1 -1 -1 -1 -1
-1 -1 -1 -1 -1 -1 -1 -1 -1 -1 -1 -1  -1 -1 -1 -1 -1 -1 -1 -1 -1 -1 -1 -1   -1 -1 -1 -1 -1 -1 -1 -1 -1 -1 -1 -1   -1 -1 -1 -1 -1 -1 -1 -1 -1 -1 -1 -1   -1 -1 -1 -1 -1 -1 -1 -1 -1 -1 -1 -1   -1 -1 -1 -1 -1 -1 -1 -1 -1 -1 -1 -1   -1 -1 -1 -1 -1 -1 -1 -1 -1 -1 -1 -1   -1 -1 -1 -1 -1 -1 -1 -1 -1 -1 -1 -1   -1 -1 -1 -1 -1 -1 -1 -1 -1 -1 -1 -1   -1 -1 -1 -1 -1 -1 -1 -1 -1 -1 -1 -1   -1 -1 -1 -1 -1 -1 -1 -1 -1 -1 -1 -1   -1 -1 -1 -1 -1 -1 -1 -1 -1 -1 -1 -1   -1 -1 -1 -1 -1 -1 -1 -1 -1 -1 -1 -1   -1 -1 -1 -1 -1 -1 -1 -1 -1 -1 -1 -1
-1 -1 -1 -1 -1 -1 -1 -1 -1 -1 -1 -1  -1 -1 -1 -1 -1 -1 -1 -1 -1 -1 -1 -1   -1 -1 -1 -1 -1 -1 -1 -1 -1 -1 -1 -1   -1 -1 -1 -1 -1 -1 -1 -1 -1 -1 -1 -1   -1 -1 -1 -1 -1 -1 -1 -1 -1 -1 -1 -1   -1 -1 -1 -1 -1 -1 -1 -1 -1 -1 -1 -1   -1 -1 -1 -1 -1 -1 -1 -1 -1 -1 -1 -1   -1 -1 -1 -1 -1 -1 -1 -1 -1 -1 -1 -1   -1 -1 -1 -1 -1 -1 -1 -1 -1 -1 -1 -1   -1 -1 -1 -1 -1 -1 -1 -1 -1 51 52 53   54 55 -1 -1 -1 -1 -1 -1 -1 -1 51 52   53 54 56 -1 -1 -1 -1 -1 -1 -1 -1 -1   -1 -1 -1 70 71 68 69 72 -1 -1 -1 -1   -1 -1 -1 -1 -1 -1 -1 -1 -1 -1 -1 -1
-1 -1 -1 -1 -1 -1 -1 -1 -1 -1 -1 -1  -1 -1 -1 -1 -1 -1 -1 -1 -1 -1 -1 -1   -1 -1 -1 -1 -1 -1 -1 -1 -1 -1 -1 -1   -1 -1 -1 -1 -1 -1 00 00 00 00 00 00   00 00 00 00 00 00 00 00 00 00 00 00   00 00 00 00 00 00 00 00 00 00 00 00   00 00 00 00 00 00 00 00 00 00 00 00   00 00 00 00 00 00 00 00 00 00 00 00   00 00 -1 -1 -1 -1 -1 -1 38 39 40 41   42 43 44 45 46 47 48 49 50 -1 -1 -1   -1 -1 51 52 53 54 47 48 49 50 -1 -1   -1 -1 -1 -1 -1 -1 -1 -1 -1 -1 -1 -1   78 68 69 -1 -1 -1 -1 -1 -1 11 11 11   11 11 11 11 11 11 11 11 11 11 11 11
17 17 17 17 17 17 17 17 17 17 17 17  17 17 17 17 17 17 17 17 17 17 17 17   -1 -1 17 17 17 17 17 17 17 17 17 17   17 33 34 35 36 37 -1 -1 -1 -1 -1 -1   -1 -1 -1 -1 -1 -1 -1 -1 -1 -1 -1 -1   -1 -1 -1 -1 -1 -1 -1 -1 -1 -1 -1 -1   -1 -1 -1 -1 -1 -1 -1 -1 -1 -1 -1 -1   -1 -1 -1 -1 -1 -1 -1 -1 -1 -1 -1 -1   -1 -1 31 30 29 29 29 -1 -1 -1 -1 -1   -1 -1 -1 31 -1 -1 -1 -1 -1 -1 -1 -1   -1 31 -1 -1 -1 -1 -1 -1 -1 -1 -1 -1   -1 -1 -1 -1 -2 -2 -2 -2 -2 -2 -2 -2   -1 -1 -1 -1 -1 -1 -1 -1 -1 -1 -1 -1   -1 -1 -1 -1 -1 -1 -1 -1 -1 -1 -1 -1
-1 -1 -1 -1 -1 -1 -1 -1 -1 -1 -1 -1  -1 -1 -1 -1 -1 -1 -1 -1 -1 -1 -1 -1   -1 -1 -1 -1 -1 -1 -1 -1 -1 -1 -1 -1   -1 -1 -1 -1 -1 -1 -1 -1 -1 -1 -1 -1   -1 -1 -1 -1 -1 -1 -1 -1 -1 -1 -1 -1   -1 -1 -1 -1 -1 -1 -1 -1 -1 -1 -1 -1   -1 -1 -1 -1 -1 -1 -1 -1 -1 -1 -1 -1   -1 -1 -1 -1 -1 -1 -1 -1 -1 -1 -1 -1   -1 -1 -1 -1 -1 -1 -1 -1 -2 -2 -2 -2   -2 -2 -2 -2 -2 -2 -2 -2 -2 -2 -2 -2   -2 -2 -2 -2 -2 -2 -2 -2 -2 -2 -2 -2   -2 -2 -2 -1 -2 -2 -2 -2 -2 -2 -2 -2   -2 -2 -2 -2 -2 -2 -2 -2 -1 -1 -2 -2   -2 -2 -2 -2 -2 -2 -2 -2 -2 -2 -2 -2
