12 7
32 32
3 2
36 14

  000 000 000 000 000 000 000 000 000 000 000 000   000 000 000 000 000 000 000 000 000 000 000 000   000 000 000 000 000 000 000 000 000 000 000 000 
  000 000 000 000 000 000 000 000 000 000 000 000   000 000 000 000 000 000 000 000 000 000 000 000   000 000 000 000 000 000 000 000 000 000 000 000 
  000 000 000 000 000 000 000 000 000 000 000 000   000 000 000 000 000 000 000 000 000 000 000 000   000 000 000 000 000 000 000 000 000 000 000 000 
  001 002 003 004 001 002 003 004 001 002 003 004   001 002 003 004 001 002 003 004 001 002 003 004   001 002 003 004 001 002 003 004 001 002 003 004 
  005 006 007 008 005 006 007 008 005 006 007 008   005 006 007 008 005 006 007 008 005 006 007 008   005 006 007 008 005 006 007 008 005 006 007 008 
  009 00a 00b 00c 009 00a 00b 00c 009 00a 00b 00c   009 00a 00b 00c 009 00a 00b 00c 009 00a 00b 00c   009 00a 00b 00c 009 00a 00b 00c 009 00a 00b 00c 
  00d 00e 00f 010 00d 00e 00f 010 00d 00e 00f 010   00d 00e 00f 010 00d 00e 00f 010 00d 00e 00f 010   00d 00e 00f 010 00d 00e 00f 010 00d 00e 00f 010 

  011 012 013 014 011 012 013 014 011 012 013 014   011 012 013 014 011 012 013 014 011 012 013 014   011 012 013 014 011 012 013 014 011 012 013 014 
  015 016 017 016 015 016 017 016 015 016 017 016   015 016 017 016 015 016 017 016 015 016 017 016   015 016 017 016 015 016 017 016 015 016 017 016 
  018 018 018 018 018 018 018 018 018 018 018 018   018 018 018 018 018 018 018 018 018 018 018 018   018 018 018 018 018 018 018 018 018 018 018 018 
  019 019 019 019 019 019 019 019 019 019 019 019   019 019 019 019 019 019 019 019 019 019 019 019   019 019 019 019 019 019 019 019 019 019 019 019 
  000 000 000 000 000 000 000 000 000 000 000 000   000 000 000 000 000 000 000 000 000 000 000 000   000 000 000 000 000 000 000 000 000 000 000 000 
  000 000 000 000 000 000 000 000 000 000 000 000   000 000 000 000 000 000 000 000 000 000 000 000   000 000 000 000 000 000 000 000 000 000 000 000 
  000 000 000 000 000 000 000 000 000 000 000 000   000 000 000 000 000 000 000 000 000 000 000 000   000 000 000 000 000 000 000 000 000 000 000 000 
